* * * * * * * * * * * * * * * * * * * * * * * * * * * * * * * * * * * * * * * * 
* - - - * * S - - * * - - - * * - - - * * S - - * * O - - * * S - - * * - - - * 
* - M - D D - N - D D - V - D D - H - D D - N - D D - N - D D - N - D D - M - * 
* - - - * * - - - * * - - - * * - - - * * - - - * * - - - * * - - - * * - - - * 
* * D * * * * D * * * * D * * * * D * * * * D * * * * D * * * * D * * * * D * * 
* * D * * * * D * * * * D * * * * D * * * * D * * * * D * * * * D * * * * D * * 
* - - - * * - - - * * G - - * * - - - * * - - - * * - - - * * - - - * * - - - * 
* - H - D D - H - D D - N - D D - M - D D - X - D D - N - D D - V - D D - i - * 
* - - - * * - - - * * - - - * * - - - * * - - - * * - - - * * - - - * * - - - * 
* * D * * * * D * * * * D * * * * D * * * * D * * * * D * * * * D * * * * D * * 
* * D * * * * D * * * * D * * * * D * * * * D * * * * D * * * * D * * * * D * * 
* O - - * * - - - * * - - - * * - - - * * - - - * * - - - * * - - - * * - - - * 
* - N - D D - A - D D - I - D D - M - D D - N - D D - H - D D - V - D D - V - * 
* - - - * * - - - * * - - - * * - - - * * - - - * * - - - * * - - - * * - - - * 
* * D * * * * D * * * * D * * * * D * * * * D * * * * D * * * * D * * * * D * * 
* * D * * * * D * * * * D * * * * D * * * * D * * * * D * * * * D * * * * D * * 
* - - - * * - - - * * - - - * * - - - * * S - - * * - - - * * - - - * * O - - * 
* - H - D D - M - D D - X - D D - E - D D - N - D D - H - D D - V - D D - N - * 
* - - - * * - - - * * - - - * * - - - * * - - - * * - - - * * - - - * * - - - * 
* * D * * * * D * * * * D * * * * D * * * * D * * * * D * * * * D * * * * D * * 
* * D * * * * D * * * * D * * * * D * * * * D * * * * D * * * * D * * * * D * * 
* - - - * * - - - * * G - - * * - - - * * - - - * * S - - * * - - - * * S - - * 
* - M - D D - H - D D - N - D D - H - D D - X - D D - N - D D - H - D D - N - * 
* - - - * * - - - * * - - - * * - - - * * - - - * * - - - * * - - - * * - - - * 
* * D * * * * D * * * * D * * * * D * * * * D * * * * D * * * * D * * * * D * * 
* * D * * * * D * * * * D * * * * D * * * * D * * * * D * * * * D * * * * D * * 
* - - - * * - - - * * - - - * * - - - * * - - - * * - - - * * - - - * * S - - * 
* - V - D D - N - D D - H - D D - V - D D - M - D D - M - D D - V - D D - N - * 
* - - - * * - - - * * - - - * * - - - * * - - - * * - - - * * - - - * * - - - * 
* * D * * * * D * * * * D * * * * D * * * * D * * * * D * * * * D * * * * D * * 
* * D * * * * D * * * * D * * * * D * * * * D * * * * D * * * * D * * * * D * * 
* - - - * * O - - * * G - - * * - - - * * G - - * * - - - * * - - - * * - - - * 
* - o - D D - N - D D - N - D D - N - D D - N - D D - N - D D - V - D D - X - * 
* - - - * * - - - * * - - - * * - - - * * - - - * * - - - * * - - - * * - - - * 
* * D * * * * D * * * * D * * * * D * * * * D * * * * D * * * * D * * * * D * * 
* * D * * * * D * * * * D * * * * D * * * * D * * * * D * * * * D * * * * D * * 
* - - - * * - - - * * S - - * * - - - * * - - - * * - - - * * G - - * * - - - * 
* - V - D D - V - D D - N - D D - V - D D - N - D D - V - D D - P - D D - H - * 
* - - - * * - - - * * - - - * * - - - * * - - - * * - - - * * - - - * * - - - * 
* * * * * * * * * * * * * * * * * * * * * * * * * * * * * * * * * * * * * * * * 
